2 13 31
###############################
#p * *2       *  ** * *      *#
# # # # #*# # #*# # # # # #*# #
#    * * *** **      *  3 **  #
# #*# # # # #1# #b#1# # # # #*#
#          *     **      *  **#
# # #*# # # # # #*#*#*#*# # # #
#   *   4    *   * *x* *      #
# # # # #*# # # # # # #*# #*# #
#   ****    5    *1           #
# # # # # # # # # #*# # # # #*#
#  ** *   *    2              #
###############################